Advice	Note: Uncountable Noun
Aggression	Note: Uncountable Noun
Assistance	Note: Uncountable Noun
Attention	Note: Uncountable Noun
Accommodation	Note: Uncountable Noun
Advertising	Note: Uncountable Noun
Air	Note: Uncountable Noun
Athletics	Note: Uncountable Noun
Access	Note: Uncountable Noun
Adulthood	Note: Uncountable Noun
Alcohol	Note: Uncountable Noun
Applause	Note: Uncountable Noun
Agriculture	Note: Uncountable Noun
Atmosphere	Note: Uncountable Noun
Anger	Note: Uncountable Noun
Art	Note: Uncountable Noun
Absence	Note: Uncountable Noun
Aid	Note: Uncountable Noun
Arithmetic	Note: Uncountable Noun
Age	Note: Uncountable Noun

Beauty	Note: Uncountable Noun
Beef	Note: Uncountable Noun
Bravery	Note: Uncountable Noun
Business	Note: Uncountable Noun
Blood	Note: Uncountable Noun
Botany	Note: Uncountable Noun
Bacon	Note: Uncountable Noun
Baggage	Note: Uncountable Noun
Ballet	Note: Uncountable Noun
Butter	Note: Uncountable Noun
Biology	Note: Uncountable Noun
Beer	Note: Uncountable Noun
Bread	Note: Uncountable Noun
Behavior	Note: Uncountable Noun

Cake	Note: Uncountable Noun
Cash	Note: Uncountable Noun
Chaos	Note: Uncountable Noun
Clothing	Note: Uncountable Noun
Confidence	Note: Uncountable Noun
Compassion	Note: Uncountable Noun
Calm	Note: Uncountable Noun
Corruption	Note: Uncountable Noun
Courage	Note: Uncountable Noun
Comprehension	Note: Uncountable Noun
Cheese	Note: Uncountable Noun
Currency	Note: Uncountable Noun
Carbon	Note: Uncountable Noun
Cardboard	Note: Uncountable Noun
Chalk	Note: Uncountable Noun
Chess	Note: Uncountable Noun
Coal	Note: Uncountable Noun
Commerce	Note: Uncountable Noun
Confusion	Note: Uncountable Noun
Cookery	Note: Uncountable Noun
Countryside	Note: Uncountable Noun
Crockery	Note: Uncountable Noun
Cutlery	Note: Uncountable Noun
Chocolate	Note: Uncountable Noun
Content	Note: Uncountable Noun
Cotton	Note: Uncountable Noun
Childhood	Note: Uncountable Noun
Coffee	Note: Uncountable Noun

Danger	Note: Uncountable Noun
Data	Note: Uncountable Noun
Dancing	Note: Uncountable Noun
Democracy	Note: Uncountable Noun
Damage	Note: Uncountable Noun
Darkness	Note: Uncountable Noun
Determination	Note: Uncountable Noun
Delight	Note: Uncountable Noun
Depression	Note: Uncountable Noun
Driving	Note: Uncountable Noun
Dignity	Note: Uncountable Noun
Dessert	Note: Uncountable Noun
Design	Note: Uncountable Noun
Dust	Note: Uncountable Noun
Distribution	Note: Uncountable Noun
Dirt	Note: Uncountable Noun
Duty	Note: Uncountable Noun

Education	Note: Uncountable Noun
Economics	Note: Uncountable Noun
Equipment	Note: Uncountable Noun
Earth	Note: Uncountable Noun
Expense	Note: Uncountable Noun
Energy	Note: Uncountable Noun
Electricity	Note: Uncountable Noun
Enthusiasm	Note: Uncountable Noun
Environment	Note: Uncountable Noun
Enjoyment	Note: Uncountable Noun
Energy	Note: Uncountable Noun
Envy	Note: Uncountable Noun
Evil	Note: Uncountable Noun
Engineering	Note: Uncountable Noun
Entertainment	Note: Uncountable Noun
Evolution	Note: Uncountable Noun
Existence	Note: Uncountable Noun
Ethics	Note: Uncountable Noun
Evidence	Note: Uncountable Noun
Employment	Note: Uncountable Noun
Experience	Note: Uncountable Noun

Failure	Note: Uncountable Noun
Fire	Note: Uncountable Noun
Fiction	Note: Uncountable Noun
Fashion	Note: Uncountable Noun
Forgiveness	Note: Uncountable Noun
Faith	Note: Uncountable Noun
Flour	Note: Uncountable Noun
Flu	Note: Uncountable Noun
Fear	Note: Uncountable Noun
Fun	Note: Uncountable Noun
Fame	Note: Uncountable Noun
Freedom	Note: Uncountable Noun
Food	Note: Uncountable Noun
Finance	Note: Uncountable Noun
Fruit	Note: Uncountable Noun
Fuel	Note: Uncountable Noun
Friendship	Note: Uncountable Noun
Furniture	Note: Uncountable Noun
Flesh	Note: Uncountable Noun

Gasoline	Note: Uncountable Noun
Genetics	Note: Uncountable Noun
Garbage	Note: Uncountable Noun
Growth	Note: Uncountable Noun
Grief	Note: Uncountable Noun
Grammar	Note: Uncountable Noun
Garlic	Note: Uncountable Noun
Gossip	Note: Uncountable Noun
Gold	Note: Uncountable Noun
Gymnastics	Note: Uncountable Noun
Glass	Note: Uncountable Noun
Grass	Note: Uncountable Noun
Golf	Note: Uncountable Noun
Gratitude	Note: Uncountable Noun
Ground	Note: Uncountable Noun
Guilt	Note: Uncountable Noun

Harm	Note: Uncountable Noun
Hair	Note: Uncountable Noun
Hardware	Note: Uncountable Noun
Hydrogen	Note: Uncountable Noun
Help	Note: Uncountable Noun
Happiness	Note: Uncountable Noun
Health	Note: Uncountable Noun
Hate	Note: Uncountable Noun
Hope	Note: Uncountable Noun
Hospitality	Note: Uncountable Noun
Homework	Note: Uncountable Noun
Heat	Note: Uncountable Noun
Hatred	Note: Uncountable Noun
Hunger	Note: Uncountable Noun
Honey	Note: Uncountable Noun
Humor	Note: Uncountable Noun
Honesty	Note: Uncountable Noun
Height	Note: Uncountable Noun
Housework	Note: Uncountable Noun
History	Note: Uncountable Noun

Ice	Note: Uncountable Noun
Imagination	Note: Uncountable Noun
Information	Note: Uncountable Noun
Independence	Note: Uncountable Noun
Infrastructure	Note: Uncountable Noun
Ice cream	Note: Uncountable Noun
Importance	Note: Uncountable Noun
Intelligence	Note: Uncountable Noun
Industry	Note: Uncountable Noun
Irony	Note: Uncountable Noun
Injustice	Note: Uncountable Noun
Innocence	Note: Uncountable Noun
Iron	Note: Uncountable Noun
Insurance	Note: Uncountable Noun
Inflation	Note: Uncountable Noun

Judo	Note: Uncountable Noun
Jealousy	Note: Uncountable Noun
Jam	Note: Uncountable Noun
Jewelery	Note: Uncountable Noun
Joy	Note: Uncountable Noun
Juice	Note: Uncountable Noun
Justice	Note: Uncountable Noun

Kindness	Note: Uncountable Noun
Knowledge	Note: Uncountable Noun
Karate	Note: Uncountable Noun

Laughter	Note: Uncountable Noun
Labour	Note: Uncountable Noun
Lava	Note: Uncountable Noun
Livestock	Note: Uncountable Noun
Luggage	Note: Uncountable Noun
Lightning	Note: Uncountable Noun
Land	Note: Uncountable Noun
Leather	Note: Uncountable Noun
Linguistics	Note: Uncountable Noun
Light	Note: Uncountable Noun
Loneliness	Note: Uncountable Noun
Lack	Note: Uncountable Noun
Litter	Note: Uncountable Noun
Luck	Note: Uncountable Noun
Love	Note: Uncountable Noun
Leisure	Note: Uncountable Noun
Logic	Note: Uncountable Noun
Literature	Note: Uncountable Noun

Machinery	Note: Uncountable Noun
Mail	Note: Uncountable Noun
Mankind	Note: Uncountable Noun
Marriage	Note: Uncountable Noun
Money	Note: Uncountable Noun
Magic	Note: Uncountable Noun
Marble	Note: Uncountable Noun
Mercy	Note: Uncountable Noun
Music	Note: Uncountable Noun
Meat	Note: Uncountable Noun
Management	Note: Uncountable Noun
Mathematics	Note: Uncountable Noun
Moonlight	Note: Uncountable Noun
Methane	Note: Uncountable Noun
Milk	Note: Uncountable Noun
Metal	Note: Uncountable Noun
Mayonnaise	Note: Uncountable Noun
Mud	Note: Uncountable Noun
Mist	Note: Uncountable Noun
Motivation	Note: Uncountable Noun
Motherhood	Note: Uncountable Noun
Measles	Note: Uncountable Noun

Nature	Note: Uncountable Noun
Nitrogen	Note: Uncountable Noun
Nutrition	Note: Uncountable Noun
Noise	Note: Uncountable Noun
News	Note: Uncountable Noun
Nonsense	Note: Uncountable Noun
Nurture	Note: Uncountable Noun

Obedience	Note: Uncountable Noun
Obesity	Note: Uncountable Noun
Oxygen	Note: Uncountable Noun
Oil	Note: Uncountable Noun

Paper	Note: Uncountable Noun
Passion	Note: Uncountable Noun
Poetry	Note: Uncountable Noun
Parking	Note: Uncountable Noun
Pressure	Note: Uncountable Noun
Perfume	Note: Uncountable Noun
Physics	Note: Uncountable Noun
Psychology	Note: Uncountable Noun
Peel	Note: Uncountable Noun
Pepper	Note: Uncountable Noun
Patience	Note: Uncountable Noun
Permission	Note: Uncountable Noun
Peace	Note: Uncountable Noun
Philosophy	Note: Uncountable Noun
Plastic	Note: Uncountable Noun
Progress	Note: Uncountable Noun
Production	Note: Uncountable Noun
Pollution	Note: Uncountable Noun
Pleasure	Note: Uncountable Noun
Pork	Note: Uncountable Noun
Petrol	Note: Uncountable Noun
Pronunciation	Note: Uncountable Noun
Pride	Note: Uncountable Noun
Policy	Note: Uncountable Noun
Purity	Note: Uncountable Noun
Poverty	Note: Uncountable Noun
Punctuation	Note: Uncountable Noun
Power	Note: Uncountable Noun
Produce	Note: Uncountable Noun
Protection	Note: Uncountable Noun
Publicity	Note: Uncountable Noun
Pasta	Note: Uncountable Noun
Pay	Note: Uncountable Noun
Pain	Note: Uncountable Noun
Painting	Note: Uncountable Noun

Quartz	Note: Uncountable Noun
Quality	Note: Uncountable Noun
Quantity	Note: Uncountable Noun

Reliability	Note: Uncountable Noun
Rum	Note: Uncountable Noun
Recreation	Note: Uncountable Noun
Reality	Note: Uncountable Noun
Rubbish	Note: Uncountable Noun
Revenge	Note: Uncountable Noun
Racism	Note: Uncountable Noun
Rice	Note: Uncountable Noun
Relief	Note: Uncountable Noun
Respect	Note: Uncountable Noun
Rain	Note: Uncountable Noun
Relaxation	Note: Uncountable Noun
Research	Note: Uncountable Noun
Religion	Note: Uncountable Noun

Salt	Note: Uncountable Noun
Safety	Note: Uncountable Noun
Salad	Note: Uncountable Noun
Scaffolding	Note: Uncountable Noun
Soil	Note: Uncountable Noun
Satisfaction	Note: Uncountable Noun
Sand	Note: Uncountable Noun
Satire	Note: Uncountable Noun
Security	Note: Uncountable Noun
Sorrow	Note: Uncountable Noun
Seafood	Note: Uncountable Noun
Speed	Note: Uncountable Noun
Scenery	Note: Uncountable Noun
Sewing	Note: Uncountable Noun
Strength	Note: Uncountable Noun
Space	Note: Uncountable Noun
Software	Note: Uncountable Noun
Seaside	Note: Uncountable Noun
Stream	Note: Uncountable Noun
Stupidity	Note: Uncountable Noun
Shopping	Note: Uncountable Noun
Stress	Note: Uncountable Noun
Shame	Note: Uncountable Noun
Spite	Note: Uncountable Noun
Steam	Note: Uncountable Noun
Silence	Note: Uncountable Noun
Sunshine	Note: Uncountable Noun
Sleep	Note: Uncountable Noun
Status	Note: Uncountable Noun
Success	Note: Uncountable Noun
Soup	Note: Uncountable Noun
Snow	Note: Uncountable Noun
Smoking	Note: Uncountable Noun
Silver	Note: Uncountable Noun
Symmetry	Note: Uncountable Noun
Spaghetti	Note: Uncountable Noun
Spelling	Note: Uncountable Noun
Soap	Note: Uncountable Noun
Sport	Note: Uncountable Noun
Stuff	Note: Uncountable Noun
Sugar	Note: Uncountable Noun
Smoke	Note: Uncountable Noun

Tea	Note: Uncountable Noun
Tolerance	Note: Uncountable Noun
Thirst	Note: Uncountable Noun
Technology	Note: Uncountable Noun
Trousers	Note: Uncountable Noun
Tennis	Note: Uncountable Noun
Trade	Note: Uncountable Noun
Timber	Note: Uncountable Noun
Turbulence	Note: Uncountable Noun
Toothpaste	Note: Uncountable Noun
Time	Note: Uncountable Noun
Traffic	Note: Uncountable Noun
Travel	Note: Uncountable Noun
Toast	Note: Uncountable Noun
Thunder	Note: Uncountable Noun
Transportation	Note: Uncountable Noun
Trust	Note: Uncountable Noun
Trouble	Note: Uncountable Noun
Temperature	Note: Uncountable Noun

Understanding	Note: Uncountable Noun
Usage	Note: Uncountable Noun
Underwear	Note: Uncountable Noun
Unemployment	Note: Uncountable Noun
Unity	Note: Uncountable Noun

Violence	Note: Uncountable Noun
Veal	Note: Uncountable Noun
Validity	Note: Uncountable Noun
Vitality	Note: Uncountable Noun
Vinegar	Note: Uncountable Noun
Vision	Note: Uncountable Noun
Vegetation	Note: Uncountable Noun
Vegetarianism	Note: Uncountable Noun
Vengeance	Note: Uncountable Noun

Warmth	Note: Uncountable Noun
Weight	Note: Uncountable Noun
Whiskey	Note: Uncountable Noun
Weather	Note: Uncountable Noun
Wildlife	Note: Uncountable Noun
Water	Note: Uncountable Noun
Welfare	Note: Uncountable Noun
Wine	Note: Uncountable Noun
Wisdom	Note: Uncountable Noun
Wood	Note: Uncountable Noun
Wealth	Note: Uncountable Noun
Wheat	Note: Uncountable Noun
Wool	Note: Uncountable Noun
Width	Note: Uncountable Noun
Work	Note: Uncountable Noun

Yoga	Note: Uncountable Noun
Youth	Note: Uncountable Noun
Yeast	Note: Uncountable Noun

Zoology	Note: Uncountable Noun
Zinc	Note: Uncountable Noun




Advices	Note: Advice is uncountable noun
Aggressions	Note: Aggression is uncountable noun
Assistances	Note: Assistance is uncountable noun
Attentions	Note: Attention is uncountable noun
Accommodations	Note: Accommodation is uncountable noun
Advertisings	Note: Advertising is uncountable noun
Airs	Note: Air is uncountable noun
Athleticss	Note: Athletics is uncountable noun
Accesss	Note: Access is uncountable noun
Adulthoods	Note: Adulthood is uncountable noun
Alcohols	Note: Alcohol is uncountable noun
Applauses	Note: Applause is uncountable noun
Agricultures	Note: Agriculture is uncountable noun
Atmospheres	Note: Atmosphere is uncountable noun
Angers	Note: Anger is uncountable noun
Arts	Note: Art is uncountable noun
Absences	Note: Absence is uncountable noun
Aids	Note: Aid is uncountable noun
Arithmetics	Note: Arithmetic is uncountable noun
Ages	Note: Age is uncountable noun

Beauties	Note: Beauty is uncountable noun
Beefs	Note: Beef is uncountable noun
Braveries	Note: Bravery is uncountable noun
Businesss	Note: Business is uncountable noun
Bloods	Note: Blood is uncountable noun
Botanies	Note: Botany is uncountable noun
Bacons	Note: Bacon is uncountable noun
Baggages	Note: Baggage is uncountable noun
Ballets	Note: Ballet is uncountable noun
Butters	Note: Butter is uncountable noun
Biologies	Note: Biology is uncountable noun
Beers	Note: Beer is uncountable noun
Breads	Note: Bread is uncountable noun
Behaviors	Note: Behavior is uncountable noun

Cakes	Note: Cake is uncountable noun
Cashs	Note: Cash is uncountable noun
Chaoss	Note: Chaos is uncountable noun
Clothings	Note: Clothing is uncountable noun
Confidences	Note: Confidence is uncountable noun
Compassions	Note: Compassion is uncountable noun
Calms	Note: Calm is uncountable noun
Corruptions	Note: Corruption is uncountable noun
Courages	Note: Courage is uncountable noun
Comprehensions	Note: Comprehension is uncountable noun
Cheeses	Note: Cheese is uncountable noun
Currencies	Note: Currency is uncountable noun
Carbons	Note: Carbon is uncountable noun
Cardboards	Note: Cardboard is uncountable noun
Chalks	Note: Chalk is uncountable noun
Chesss	Note: Chess is uncountable noun
Coals	Note: Coal is uncountable noun
Commerces	Note: Commerce is uncountable noun
Confusions	Note: Confusion is uncountable noun
Cookeries	Note: Cookery is uncountable noun
Countrysides	Note: Countryside is uncountable noun
Crockeries	Note: Crockery is uncountable noun
Cutleries	Note: Cutlery is uncountable noun
Chocolates	Note: Chocolate is uncountable noun
Contents	Note: Content is uncountable noun
Cottons	Note: Cotton is uncountable noun
Childhoods	Note: Childhood is uncountable noun
Coffees	Note: Coffee is uncountable noun

Dangers	Note: Danger is uncountable noun
Datas	Note: Data is uncountable noun
Dancings	Note: Dancing is uncountable noun
Democracies	Note: Democracy is uncountable noun
Damages	Note: Damage is uncountable noun
Darknesss	Note: Darkness is uncountable noun
Determinations	Note: Determination is uncountable noun
Delights	Note: Delight is uncountable noun
Depressions	Note: Depression is uncountable noun
Drivings	Note: Driving is uncountable noun
Dignities	Note: Dignity is uncountable noun
Desserts	Note: Dessert is uncountable noun
Designs	Note: Design is uncountable noun
Dusts	Note: Dust is uncountable noun
Distributions	Note: Distribution is uncountable noun
Dirts	Note: Dirt is uncountable noun
Duties	Note: Duty is uncountable noun

Educations	Note: Education is uncountable noun
Economicss	Note: Economics is uncountable noun
Equipments	Note: Equipment is uncountable noun
Earths	Note: Earth is uncountable noun
Expenses	Note: Expense is uncountable noun
Energies	Note: Energy is uncountable noun
Electricities	Note: Electricity is uncountable noun
Enthusiasms	Note: Enthusiasm is uncountable noun
Environments	Note: Environment is uncountable noun
Enjoyments	Note: Enjoyment is uncountable noun
Energies	Note: Energy is uncountable noun
Envies	Note: Envy is uncountable noun
Evils	Note: Evil is uncountable noun
Engineerings	Note: Engineering is uncountable noun
Entertainments	Note: Entertainment is uncountable noun
Evolutions	Note: Evolution is uncountable noun
Existences	Note: Existence is uncountable noun
Ethicss	Note: Ethics is uncountable noun
Evidences	Note: Evidence is uncountable noun
Employments	Note: Employment is uncountable noun
Experiences	Note: Experience is uncountable noun

Failures	Note: Failure is uncountable noun
Fires	Note: Fire is uncountable noun
Fictions	Note: Fiction is uncountable noun
Fashions	Note: Fashion is uncountable noun
Forgivenesss	Note: Forgiveness is uncountable noun
Faiths	Note: Faith is uncountable noun
Flours	Note: Flour is uncountable noun
Flus	Note: Flu is uncountable noun
Fears	Note: Fear is uncountable noun
Funs	Note: Fun is uncountable noun
Fames	Note: Fame is uncountable noun
Freedoms	Note: Freedom is uncountable noun
Foods	Note: Food is uncountable noun
Finances	Note: Finance is uncountable noun
Fruits	Note: Fruit is uncountable noun
Fuels	Note: Fuel is uncountable noun
Friendships	Note: Friendship is uncountable noun
Furnitures	Note: Furniture is uncountable noun
Fleshs	Note: Flesh is uncountable noun

Gasolines	Note: Gasoline is uncountable noun
Geneticss	Note: Genetics is uncountable noun
Garbages	Note: Garbage is uncountable noun
Growths	Note: Growth is uncountable noun
Griefs	Note: Grief is uncountable noun
Grammars	Note: Grammar is uncountable noun
Garlics	Note: Garlic is uncountable noun
Gossips	Note: Gossip is uncountable noun
Golds	Note: Gold is uncountable noun
Gymnasticss	Note: Gymnastics is uncountable noun
Glasss	Note: Glass is uncountable noun
Grasss	Note: Grass is uncountable noun
Golfs	Note: Golf is uncountable noun
Gratitudes	Note: Gratitude is uncountable noun
Grounds	Note: Ground is uncountable noun
Guilts	Note: Guilt is uncountable noun

Harms	Note: Harm is uncountable noun
Hairs	Note: Hair is uncountable noun
Hardwares	Note: Hardware is uncountable noun
Hydrogens	Note: Hydrogen is uncountable noun
Helps	Note: Help is uncountable noun
Happinesss	Note: Happiness is uncountable noun
Healths	Note: Health is uncountable noun
Hates	Note: Hate is uncountable noun
Hopes	Note: Hope is uncountable noun
Hospitalities	Note: Hospitality is uncountable noun
Homeworks	Note: Homework is uncountable noun
Heats	Note: Heat is uncountable noun
Hatreds	Note: Hatred is uncountable noun
Hungers	Note: Hunger is uncountable noun
Honeys	Note: Honey is uncountable noun
Humors	Note: Humor is uncountable noun
Honesties	Note: Honesty is uncountable noun
Heights	Note: Height is uncountable noun
Houseworks	Note: Housework is uncountable noun
Histories	Note: History is uncountable noun

Ices	Note: Ice is uncountable noun
Imaginations	Note: Imagination is uncountable noun
Informations	Note: Information is uncountable noun
Independences	Note: Independence is uncountable noun
Infrastructures	Note: Infrastructure is uncountable noun
Ice creams	Note: cream is uncountable noun
Importances	Note: Importance is uncountable noun
Intelligences	Note: Intelligence is uncountable noun
Industries	Note: Industry is uncountable noun
Ironies	Note: Irony is uncountable noun
Injustices	Note: Injustice is uncountable noun
Innocences	Note: Innocence is uncountable noun
Irons	Note: Iron is uncountable noun
Insurances	Note: Insurance is uncountable noun
Inflations	Note: Inflation is uncountable noun

Judos	Note: Judo is uncountable noun
Jealousies	Note: Jealousy is uncountable noun
Jams	Note: Jam is uncountable noun
Jeweleries	Note: Jewelery is uncountable noun
Joys	Note: Joy is uncountable noun
Juices	Note: Juice is uncountable noun
Justices	Note: Justice is uncountable noun

Kindnesss	Note: Kindness is uncountable noun
Knowledges	Note: Knowledge is uncountable noun
Karates	Note: Karate is uncountable noun

Laughters	Note: Laughter is uncountable noun
Labours	Note: Labour is uncountable noun
Lavas	Note: Lava is uncountable noun
Livestocks	Note: Livestock is uncountable noun
Luggages	Note: Luggage is uncountable noun
Lightnings	Note: Lightning is uncountable noun
Lands	Note: Land is uncountable noun
Leathers	Note: Leather is uncountable noun
Linguisticss	Note: Linguistics is uncountable noun
Lights	Note: Light is uncountable noun
Lonelinesss	Note: Loneliness is uncountable noun
Lacks	Note: Lack is uncountable noun
Litters	Note: Litter is uncountable noun
Lucks	Note: Luck is uncountable noun
Loves	Note: Love is uncountable noun
Leisures	Note: Leisure is uncountable noun
Logics	Note: Logic is uncountable noun
Literatures	Note: Literature is uncountable noun

Machineries	Note: Machinery is uncountable noun
Mails	Note: Mail is uncountable noun
Mankinds	Note: Mankind is uncountable noun
Marriages	Note: Marriage is uncountable noun
Moneys	Note: Money is uncountable noun
Magics	Note: Magic is uncountable noun
Marbles	Note: Marble is uncountable noun
Mercies	Note: Mercy is uncountable noun
Musics	Note: Music is uncountable noun
Meats	Note: Meat is uncountable noun
Managements	Note: Management is uncountable noun
Mathematicss	Note: Mathematics is uncountable noun
Moonlights	Note: Moonlight is uncountable noun
Methanes	Note: Methane is uncountable noun
Milks	Note: Milk is uncountable noun
Metals	Note: Metal is uncountable noun
Mayonnaises	Note: Mayonnaise is uncountable noun
Muds	Note: Mud is uncountable noun
Mists	Note: Mist is uncountable noun
Motivations	Note: Motivation is uncountable noun
Motherhoods	Note: Motherhood is uncountable noun
Measless	Note: Measles is uncountable noun

Natures	Note: Nature is uncountable noun
Nitrogens	Note: Nitrogen is uncountable noun
Nutritions	Note: Nutrition is uncountable noun
Noises	Note: Noise is uncountable noun
Newss	Note: News is uncountable noun
Nonsenses	Note: Nonsense is uncountable noun
Nurtures	Note: Nurture is uncountable noun

Obediences	Note: Obedience is uncountable noun
Obesities	Note: Obesity is uncountable noun
Oxygens	Note: Oxygen is uncountable noun
Oils	Note: Oil is uncountable noun

Papers	Note: Paper is uncountable noun
Passions	Note: Passion is uncountable noun
Poetries	Note: Poetry is uncountable noun
Parkings	Note: Parking is uncountable noun
Pressures	Note: Pressure is uncountable noun
Perfumes	Note: Perfume is uncountable noun
Physicss	Note: Physics is uncountable noun
Psychologies	Note: Psychology is uncountable noun
Peels	Note: Peel is uncountable noun
Peppers	Note: Pepper is uncountable noun
Patiences	Note: Patience is uncountable noun
Permissions	Note: Permission is uncountable noun
Peaces	Note: Peace is uncountable noun
Philosophies	Note: Philosophy is uncountable noun
Plastics	Note: Plastic is uncountable noun
Progresss	Note: Progress is uncountable noun
Productions	Note: Production is uncountable noun
Pollutions	Note: Pollution is uncountable noun
Pleasures	Note: Pleasure is uncountable noun
Porks	Note: Pork is uncountable noun
Petrols	Note: Petrol is uncountable noun
Pronunciations	Note: Pronunciation is uncountable noun
Prides	Note: Pride is uncountable noun
Policies	Note: Policy is uncountable noun
Purities	Note: Purity is uncountable noun
Poverties	Note: Poverty is uncountable noun
Punctuations	Note: Punctuation is uncountable noun
Powers	Note: Power is uncountable noun
Produces	Note: Produce is uncountable noun
Protections	Note: Protection is uncountable noun
Publicities	Note: Publicity is uncountable noun
Pastas	Note: Pasta is uncountable noun
Pays	Note: Pay is uncountable noun
Pains	Note: Pain is uncountable noun
Paintings	Note: Painting is uncountable noun

Quartzs	Note: Quartz is uncountable noun
Qualities	Note: Quality is uncountable noun
Quantities	Note: Quantity is uncountable noun

Reliabilities	Note: Reliability is uncountable noun
Rums	Note: Rum is uncountable noun
Recreations	Note: Recreation is uncountable noun
Realities	Note: Reality is uncountable noun
Rubbishs	Note: Rubbish is uncountable noun
Revenges	Note: Revenge is uncountable noun
Racisms	Note: Racism is uncountable noun
Rices	Note: Rice is uncountable noun
Reliefs	Note: Relief is uncountable noun
Respects	Note: Respect is uncountable noun
Rains	Note: Rain is uncountable noun
Relaxations	Note: Relaxation is uncountable noun
Researchs	Note: Research is uncountable noun
Religions	Note: Religion is uncountable noun

Salts	Note: Salt is uncountable noun
Safeties	Note: Safety is uncountable noun
Salads	Note: Salad is uncountable noun
Scaffoldings	Note: Scaffolding is uncountable noun
Soils	Note: Soil is uncountable noun
Satisfactions	Note: Satisfaction is uncountable noun
Sands	Note: Sand is uncountable noun
Satires	Note: Satire is uncountable noun
Securities	Note: Security is uncountable noun
Sorrows	Note: Sorrow is uncountable noun
Seafoods	Note: Seafood is uncountable noun
Speeds	Note: Speed is uncountable noun
Sceneries	Note: Scenery is uncountable noun
Sewings	Note: Sewing is uncountable noun
Strengths	Note: Strength is uncountable noun
Spaces	Note: Space is uncountable noun
Softwares	Note: Software is uncountable noun
Seasides	Note: Seaside is uncountable noun
Streams	Note: Stream is uncountable noun
Stupidities	Note: Stupidity is uncountable noun
Shoppings	Note: Shopping is uncountable noun
Stresss	Note: Stress is uncountable noun
Shames	Note: Shame is uncountable noun
Spites	Note: Spite is uncountable noun
Steams	Note: Steam is uncountable noun
Silences	Note: Silence is uncountable noun
Sunshines	Note: Sunshine is uncountable noun
Sleeps	Note: Sleep is uncountable noun
Statuss	Note: Status is uncountable noun
Successs	Note: Success is uncountable noun
Soups	Note: Soup is uncountable noun
Snows	Note: Snow is uncountable noun
Smokings	Note: Smoking is uncountable noun
Silvers	Note: Silver is uncountable noun
Symmetries	Note: Symmetry is uncountable noun
Spaghettis	Note: Spaghetti is uncountable noun
Spellings	Note: Spelling is uncountable noun
Soaps	Note: Soap is uncountable noun
Sports	Note: Sport is uncountable noun
Stuffs	Note: Stuff is uncountable noun
Sugars	Note: Sugar is uncountable noun
Smokes	Note: Smoke is uncountable noun

Teas	Note: Tea is uncountable noun
Tolerances	Note: Tolerance is uncountable noun
Thirsts	Note: Thirst is uncountable noun
Technologies	Note: Technology is uncountable noun
Trouserss	Note: Trousers is uncountable noun
Tenniss	Note: Tennis is uncountable noun
Trades	Note: Trade is uncountable noun
Timbers	Note: Timber is uncountable noun
Turbulences	Note: Turbulence is uncountable noun
Toothpastes	Note: Toothpaste is uncountable noun
Times	Note: Time is uncountable noun
Traffics	Note: Traffic is uncountable noun
Travels	Note: Travel is uncountable noun
Toasts	Note: Toast is uncountable noun
Thunders	Note: Thunder is uncountable noun
Transportations	Note: Transportation is uncountable noun
Trusts	Note: Trust is uncountable noun
Troubles	Note: Trouble is uncountable noun
Temperatures	Note: Temperature is uncountable noun

Understandings	Note: Understanding is uncountable noun
Usages	Note: Usage is uncountable noun
Underwears	Note: Underwear is uncountable noun
Unemployments	Note: Unemployment is uncountable noun
Unities	Note: Unity is uncountable noun

Violences	Note: Violence is uncountable noun
Veals	Note: Veal is uncountable noun
Validities	Note: Validity is uncountable noun
Vitalities	Note: Vitality is uncountable noun
Vinegars	Note: Vinegar is uncountable noun
Visions	Note: Vision is uncountable noun
Vegetations	Note: Vegetation is uncountable noun
Vegetarianisms	Note: Vegetarianism is uncountable noun
Vengeances	Note: Vengeance is uncountable noun

Warmths	Note: Warmth is uncountable noun
Weights	Note: Weight is uncountable noun
Whiskeies	Note: Whiskey is uncountable noun
Weathers	Note: Weather is uncountable noun
Wildlifes	Note: Wildlife is uncountable noun
Waters	Note: Water is uncountable noun
Welfares	Note: Welfare is uncountable noun
Wines	Note: Wine is uncountable noun
Wisdoms	Note: Wisdom is uncountable noun
Woods	Note: Wood is uncountable noun
Wealths	Note: Wealth is uncountable noun
Wheats	Note: Wheat is uncountable noun
Wools	Note: Wool is uncountable noun
Widths	Note: Width is uncountable noun
Works	Note: Work is uncountable noun

Yogas	Note: Yoga is uncountable noun
Youths	Note: Youth is uncountable noun
Yeasts	Note: Yeast is uncountable noun

Zoologies	Note: Zoology is uncountable noun
Zincs	Note: Zinc is uncountable noun